111111111111
1P0000000111
10000C111111
111100000001
100C00000000
1C1110111101
1011111E1111
101111101111
10C000001111
111111111111
