111111111111
1P0000000111
10000C111111
111100000001
100C00000001
1C1110111101
1011111E1111
101111101111
10C000001111
100000110001
100000000001
111001110001
111111111111
